MMM	3M Company
NDN	99 Cents Only Stores
CAS	A. M. Castle & Co.
AOS	A. O. Smith Corporation
AHC	A.H. Belo Corporation
AIR	AAR Corporation
AAN	Aaron's Inc.
ABT	Abbott Laboratories
ANF	Abercrombie & Fitch
ABH	AbitibiBowater Inc.
ABM	ABM Industries Incorporated
ABVT	AboveNet, Inc.
AKR	Acadia Realty Trust
ACN	Accenture plc
ABD	ACCO Brands Corporation
AH	Accretive Health, Inc.
ACW	Accuride Corporation
ACE	ACE Limited
ATU	Actuant Corporation
AYI	Acuity Brands, Inc. (Holding Company)
AGRO	Adecoagro S.A.
AEA	Advance America, Cash Advance Centers, Inc.
AAP	Advance Auto Parts, Inc.
AMD	Advanced Micro Devices, Inc.
AAV	Advantage Oil & Gas Ltd.
ACM	AECOM Technology Corporation
ANW	Aegean Marine Petroleum Network Inc.
AEI	AEI
AER	AerCap Holdings N.V.
ARX	Aeroflex Holding Corp.
ARO	Aeropostale, Inc.
AES	The AES Corporation
AET	Aetna, Inc.
AMG	Affiliated Managers Group
AFL	AFLAC Incorporated
AGCO	Agco Corporation
A	Agilent Technologies Inc.
AGL	AGL Resources Inc.
AEM	Agnico-Eagle Mines Limited
ADC	Agree Realty Corporation
AGU	Agrium Inc.
APD	Air Products and Chemicals, Inc.
AYR	Aircastle Limited
ARG	Airgas, Inc.
AAI	AirTran Holdings, Inc.
AKS	AK Steel Holding Corp
ALG	Alamo Group Inc.
ALK	Alaska Air Group, Inc.
AIN	Albany International Corp/DE/
ALB	Albemarle Corporation
ACV	Alberto-Culver Company
AA	Alcoa, Inc.
ACL	Alcon Inc.
ALR	Alere Inc.
ALEX	Alexander & Baldwin, Inc.
ALX	Alexanders Inc.
ARE	Alexandria Real Estate Equities Inc.
Y	Alleghany Corporation
AYE	Allegheny Energy Inc
ATI	Allegheny Technologies Incorporated
AGN	Allergan Inc.
ALE	ALLETE, Inc.
ADS	Alliance Data Systems Corporation
AIQ	Alliance Healthcare Services, Inc.
AOI	Alliance One International, Inc.
AB	AllianceBernstein Holding L.P.
LNT	Alliant Energy Corporation
ATK	Alliant Techsystems Inc.
AWH	Allied World Assurance Company Holdings, Ltd.
ALY	Allis-Chalmers Energy Inc.
ALL	Allstate Corporation
ALJ	Alon USA Energy, Inc.
ANR	Alpha Natural Resources, Inc.
MO	Altria Group, Inc.
AMB	AMB Property Corporation
ACO	Amcol International Corporation
DOX	Amdocs Ltd
AEE	Ameren Corporation
AMRC	Ameresco, Inc.
AAT	American Assets Trust, Inc.
AXL	American Axle & Manufacturing Holdings, Inc.
ACC	American Campus Communities, Inc.
AEO	American Eagle Outfitters, Inc.
AEP	American Electric Power Company Inc
AEL	American Equity Investment Life Holding Company
AXP	American Express Company
AFG	American Financial Group Inc.
AM	American Greetings Corporation
AIG	American International Group Inc
AOB	American Oriental Bioengineering, Inc.
ARL	American Realty Investors, Inc.
ARC	American Reprographics Company
ASI	American Safety Insurance Holdings, Ltd.
AWR	American States Water Co.
AMT	American Tower Corporation
AVD	American Vanguard Corporation
AWK	American Water Works Company, Inc.
ACRE	Americold Realty Trust
ACF	AmeriCredit Corp.
APU	Amerigas Partners lp
AGP	AMERIGROUP Corporation
AMP	Ameriprise Financial, Inc.
ABC	AmerisourceBergen Corporation
AMN	Ameron Internation Corporation
AME	Ametek Inc.
AHS	AMN Healthcare Services, Inc.
AP	Ampco-Pittsburgh Corporation
APH	Amphenol Corporation
AMR	AMR Corporation
AXR	AMREP Corporation
APC	Anadarko Petroleum Corporation
ADI	Analog Devices Inc.
AXE	Anixter International Inc.
ANN	Ann Inc.
NLY	Annaly Capital Management, Inc.
ANH	Anworth Mortgage Asset Corporation
AOL	AOL Inc.
AON	Aon Corporation
APA	Apache Corporation
AIV	Apartment Investment & Management Company
ARI	Apollo Commercial Real Estate Finance, Inc.
APO	Apollo Global Management, LLC
AIT	Applied Industrial Technologies, Inc.
ATR	AptarGroup Inc.
WTR	Aqua America, Inc.
ARB	Arbitron, Inc.
ABR	Arbor Realty Trust, Inc.
ARJ	Arch Chemicals, Inc.
ACI	Arch Coal Inc
ADM	Archer Daniels Midland Co.
AI	Arlington Asset Investment Corporation
AWI	Armstrong World Industries, Inc.
ARW	Arrow Electronics Inc
AJG	Arthur J.Gallagher & Co.
ART	Artio Global Investors, Inc.
ABG	Asbury Automotive Group, Inc.
AHT	Ashford Hospitality Trust, Inc.
ASH	Ashland Inc.
AHL	Aspen Insurance Holdings Limited
ALC	Assisted Living Concepts, Inc.
AEC	Associated Estates Realty Corporation
AIZ	Assurant, Inc.
AGO	Assured Guaranty Ltd.
AF	Astoria Financial Corporation
T	AT&T Inc.
AT	Atlantic Power Corporation
AHD	Atlas Energy, L.P.
APL	Atlas Pipeline Partners, L.P.
ATO	Atmos Energy Corporation
ATW	Atwood Oceanics Inc.
ALV	Autoliv Inc.
AN	Autonation Inc
AZO	AutoZone, Inc
AVB	AvalonBay Communities, Inc.
AVO	The Aveon Group L.P.
AVY	Avery Dennison Corporation
CAR	Avis Budget Group, Inc.
AVA	Avista Corporation
AVT	Avnet Inc
AVP	Avon Products, Inc.
AVX	Avx Corporation
AXS	Axis Capital Holdings Limited
AZZ	AZZ incorporated
BGS	B&G Foods, Inc.
BWC	The Babcock & Wilcox Company
BMI	Badger Meter, Inc.
BHI	Baker Hughes Inc.
BEZ	Baldor Electric Co.
BLL	Ball Corporation
BYI	Bally Technologies, Inc.
BALT	Baltic Trading Limited
BLX	Banco Latinoamericano De Comercio Exterior, S.A.
BXS	BancorpSouth Inc
BAC	Bank of America Corporation
BOH	Bank of Hawaii Corporation
BK	The Bank of New York Mellon Corporation
BNS	The Bank of Nova Scotia
BBX	BankAtlantic Bancorp, Inc.
BKU	BankUnited, Inc.
BKS	Barnes & Noble Inc
B	Barnes Group Inc
ABX	Barrick Gold Corporation
BAS	Basic Energy Services, Inc.
BAX	Baxter International  Inc
BTE	Baytex Energy Corp.
BBT	BB&T Corporation
BCE	BCE Inc.
BZH	Beazer Homes USA, Inc.
BEC	Beckman Coulter, Inc.
BDX	Becton, Dickinson and Company
BDC	Belden Inc.
BLC	Belo Corp.
BMS	Bemis Company, Inc.
BHE	Benchmark Electronics Inc
BRK.A	Berkshire Hathaway Inc
BRY	Berry Petroleum Co.
BBY	Best Buy Co.
BIG	Big Lots, Inc.
BH	Biglari Holdings Inc.
BBG	Bill Barrett Corporation
BMR	BioMed Realty Trust, Inc.
BVF	Biovail Corporation
BJ	BJ's Wholesale Club, Inc.
BKH	Black Hills Corporation
BLK	BlackRock, Inc.
BX	The Blackstone Group L.P.
BLT	Blount International Inc
BXG	Bluegreen Corporation
BXC	BlueLinx Holdings, Inc.
BTH	Blyth, Inc.
BMO	BMO Financial Group
BWP	Boardwalk Pipeline Partners, LP
BA	The Boeing Company
BZ	Boise Inc.
BAH	Booz Allen Hamilton Holding Corporation
BWA	BorgWarner Inc.
SAM	Boston Beer Co.
BXP	Boston Properties, Inc.
BSX	Boston Scientific Corporation
BYD	Boyd Gaming Corporation
BPT	BP Prudhoe Bay Royalty Trust
BRC	Brady Corporation
BDN	Brandywine Realty Trust
BRE	BRE Properties, Inc.
BPI	Bridgepoint Education, Inc.
BGG	Briggs & Stratton Corporation
BCO	The Brink's Company
EAT	Brinker International, Inc.
BMY	Bristol-Myers Squibb Company
BRS	Bristow Group Inc.
BR	Broadridge Financial Solutions, Inc.
BKD	Brookdale Senior Living Inc.
BAM	Brookfield Asset Management Inc.
BHS	Brookfield Homes Corporation
BIP	Brookfield Infrastructure Partners L.P.
BPO	Brookfield Properties Corporation
BRO	Brown & Brown Insurance
BWS	Brown Shoe Company, Inc.
BF.A	Brown-Forman Corporation
BRT	BRT Realty Trust
BC	Brunswick Corporation
BPL	Buckeye Partners Lp.
BKI	Buckeye Technologies Inc.
BKE	The Buckle, Inc.
BBW	Build-A-Bear Workshop, Inc.
BG	Bunge Limited
BCR	C. R. Bard, Inc.
CAB	Cabela's Incorporated
CVC	Cablevision Systems Corporation
CBT	Cabot Corporation
COG	Cabot Oil & Gas Corporation
CACI	CACI International Inc
CAE	CAE Inc.
CAP	CAI International, Inc.
DVR	Cal Dive International, Inc.
CCC	Calgon Carbon Corporation
CWT	California Water Service Group
CALX	Calix, Inc.
ELY	Callaway Golf Company
CPE	Callon Petroleum Co.
CPN	Calpine Corporation
CBM	Cambrex Corporation
CPT	Camden Property Trust
CCJ	Cameco Corporation
CAM	Cameron International Corporation
CPB	Campbell Soup Company
CCG	Campus Crest Communities, Inc.
CM	Canadian Imperial Bank of Commerce
CNI	Canadian National Railway Company
CNQ	Canadian Natural Resources, Ltd.
CP	Canadian Pacific Railway Limited
CMN	Cantel Medical Corporation
COF	Capital One Financial Corporation
CSU	Capital Senior Living Corporation
CT	Capital Trust, Inc.
CSE	CapitalSource, Inc.
CBC	Capitol Bancorp Limited
LSE	CapLease, Inc.
CMO	Capstead Mortgage Corporation
CRR	CARBO Ceramics Inc.
CAH	Cardinal Health Inc.
CFN	Carefusion Corporation
CSL	Carlisle Companies Inc
KMX	CarMax Group
CCL	Carnival Corporation
CRS	Carpenter Technology Corp
CSV	Carriage Services Inc
CRI	Carter's, Inc.
CASC	Cascade Corporation
CSH	Cash America International, Inc.
CSFS	The Cash Store Financial Services Inc.
CAT	Caterpillar Inc.
CATO	The Cato Corporation
CBG	CB Richard Ellis Group, Inc.
CBZ	CBIZ, Inc.
CBL	CBL & Associates Properties, Inc.
CBF	CBRE Realty Finance, Inc.
CBS	CBS Corporation
CDI	CDI Corporation
CEC	CEC Entertainment, Inc.
FUN	Cedar Fair, L.P.
CDR	Cedar Shopping Centers, Inc.
CGI	Celadon Group, Inc.
CE	Celanese Corporation
CLS	Celestica Inc.
CEL	Cellcom Israel, Ltd.
CVE	Cenovus Energy, Inc.
CNC	Centene Corporation
CNP	CenterPoint Energy, Inc.
CPF	Central Pacific Financial Corp.
CV	Central Vermont Public Service Corporation
CTL	CenturyLink, Inc.
CVO	Cenveo, Inc.
CF	CF Industries Holdings, Inc.
GIB	CGI Group Inc.
CHG	CH Energy Group, Inc.
CRL	Charles River Laboratories International, Inc.
SCHW	The Charles Schwab Corporation
CLDT	Chatham Lodging Trust
CKP	Checkpoint Systems Inc.
CHE	Chemed Corporation
CHMT	Chemtura Corporation
CHK	Chesapeake Energy Corporation
CHSP	Chesapeake Lodging Trust
CHKM	Chesapeake Midstream Partners, L.P.
CPK	Chesapeake Utilities Corporation
CVX	Chevron Corporation
CBI	Chicago Bridge & Iron Company
CHS	Chico's FAS, Inc.
CIM	Chimera Investment Corporation
CO	China Cord Blood Corporation
CSR	China Security & Surveillance Technology, Inc.
CYD	China Yuchai International Limited
CMG	Chipotle Mexican Grill, Inc.
CQB	Chiquita Brands International Inc.
CHH	Choice Hotels International, Inc.
CBK	Christopher & Banks Corporation
CB	Chubb Corporation
CHD	Church & Dwight Co Inc.
CBR	CIBER, Inc.
CI	CIGNA Corporation
XEC	Cimarex Energy Co.
CBB	Cincinnati Bell Inc.
CNK	Cinemark Holdings, Inc
CIR	Circor International, Inc.
CIT	CIT Group Inc.
C	Citigroup Inc.
CIA	Citizens, Inc.
CYN	City National Corporation
CLC	CLARCOR Inc.
DCS	Claymore Dividend & Income Fund
CLH	Clean Harbors, Inc.
CCO	Clear Channel Outdoor Holdings, Inc.
CLW	Clearwater Paper Corporation
CNL	Cleco Corporation
CLF	Cliffs Natural Resources Inc.
CLX	Clorox Corporation
CLD	Cloud Peak Energy, Inc.
CMS	CMS Energy Corporation
CNA	CNA Financial Corporation
SUR	CNA Surety Corporation
CNH	CNH Global N.V.
CNO	CNO Financial Group, Inc.
COH	Coach, Inc.
CIE	Cobalt International Energy, Inc.
KO	The Coca-Cola Company
CCE	Coca-Cola Enterprises Inc.
CDE	Coeur d'Alene Mines Corporation
CSA	Cogdell Spencer Inc.
CNS	Cohen & Steers, Inc.
CFX	Colfax Corporation
CL	Colgate-Palmolive Co.
PSS	Collective Brands, Inc.
CNB	Colonial Bancgroup Inc.
CLP	Colonial Properties Trust
CLNY	Colony Financial, Inc.
CMA	Comerica Inc.
FIX	Comfort Systems USA, Inc.
CMC	Commercial Metals Company
CWH	CommonWealth REIT
CTV	Commscope Inc.
CBU	Community Bank System, Inc.
CYH	Community Health Systems, Inc.
CODI	Compass Diversified Holdings
CMP	Compass Minerals International, Inc.
CML	Compellent Technologies, Inc.
CPX	Complete Production Services, Inc.
CSC	Computer Sciences Corporation
CIX	CompX International Inc.
CRK	Comstock Resources Inc.
CNW	Con-way Inc.
CAG	ConAgra Foods, Inc.
CXO	Concho Resources Inc.
COP	ConocoPhillips
CNX	CONSOL Energy Inc.
ED	Consolidated Edison Inc.
CGX	Consolidated Graphics, Inc.
STZ	Constellation Brands, Inc.
CEG	Constellation Energy Group Inc.
CAL	Continental Airlines, Inc.
CLR	Continental Resources, Inc.
CVG	Convergys Corporation
COO	The Cooper Companies Inc.
CBE	Cooper Industries, plc.
CTB	Cooper Tire & Rubber Co.
CPA	Copa Holdings, S.A.
CLB	Core Laboratories
CLGX	CoreLogic, INC.
COR	CoreSite Realty Corporation
CPO	Corn Products International, Inc.
GLW	Corning Inc.
EXBD	The Corporate Executive Board Company
OFC	Corporate Office Properties Trust
CXW	Corrections Corporation of America
CZZ	Cosan Limited
CMRE	Costamare Inc.
COT	Cott Corporation
CUZ	Cousins Properties Inc.
CVD	Covance Inc.
CVA	Covanta Holding Corporation
CVH	Coventry Health Care Inc.
COV	Covidien plc
CPY	CPI Corporation
CR	Crane Co.
CRD.B	Crawford & Company
BAP	Credicorp, Ltd.
CXS	CreXus Investment  Corporation
CRT	Cross Timbers Royalty Trust
CCI	Crown Castle International Corp.
CCK	Crown Holdings Inc.
CRU	Crude Carriers Corp.
CRY	CryoLife, Inc.
CSS	Css Industries Inc.
CSX	CSX Corporation
CTS	CTS Corporation
CUB	Cubic Corporation
CFR	Cullen/Frost Bankers, Inc.
CFI	Culp, Inc.
CMI	Cummins Inc.
CW	Curtiss-Wright Corporation
CVI	CVR Energy, Inc.
CVS	CVS Caremark Corporation
CY	Cypress Semiconductor Corporation
CYS	Cypress Sharpridge Investments, Inc.
CYT	Cytec Industries Inc.
DNB	D&B Corporation
DHI	D. R. Horton Inc.
DAN	Dana Holding Corporation
DHRWI	Danaher Corporation
DAC	Danaos Corporation
DRI	Darden Restaurants, Inc.
DAR	Darling International Inc.
DVA	Davita, Inc.
DPM	DCP Midstream Partners, LP
DCT	DCT Industrial Trust Inc.
DF	Dean Foods Company
DE	Deere & Company
DLM	Del Monte Foods Company
DK	Delek US Holdings, Inc.
DFG	Delphi Financial Group Inc.
DAL	Delta Air Lines, Inc.
DEL	Deltic Timber Corporation
DLX	Deluxe Corporation
DMD	Demand Media, Inc.
DNR	Denbury Resources Inc.
DB	Deutsche Bank AG
DDR	Developers Diversified Realty Corporation
DVN	Devon Energy Corporation
DV	DeVry Inc.
DEXO	DEX One Corporation
DHT	DHT Holdings, Inc.
DO	Diamond Offshore Drilling Inc.
DRH	DiamondRock Hospitality Company
DSX	Diana Shipping, Inc.
DHX	Dice Holdings, Inc.
DKS	Dick's Sporting Goods, Inc.
DBD	Diebold Inc.
DLR	Digital Realty Trust, Inc.
DGI	DigitalGlobe, Inc.
DDS	Dillards Inc.
DIN	DineEquity, Inc.
DFS	Discover Financial Services
DM	The Dolan Company
DLB	Dolby Laboratories, Inc.
DOLE	Dole Food Company, Inc.
DG	Dollar General Corporation
DTG	Dollar Thrifty Automotive Group Inc.
DOM	Dominion Resources Black Warrior Trust
D	Dominion Resources, Inc.
DPZ	Domino's Pizza, Inc.
UFS	Domtar Corporation
DCI	Donaldson Co Inc.
DRL	Doral Financial Corporation
PLOW	Douglas Dynamics, Inc.
DEI	Douglas Emmett, Inc.
DOV	Dover Corp
DDE	Dover Downs Gaming & Entertainment, Inc.
DVD	Dover Motorsports, Inc.
DOW	Dow Chemical Co.
DPL	DPL Inc.
DPS	Dr Pepper Snapple Group, Inc.
DRC	Dresser-Rand Group Inc.
DW	Drew Industries Incorporated
DRQ	Dril-Quip, Inc.
DST	DST Systems Inc.
DSW	DSW Inc.
DTE	DTE Energy Company
DCO	Ducommun Inc
DUF	Duff & Phelps Corporation
DUK	Duke Energy Corporation
DRE	Duke Realty Investments Inc.
DEP	Duncan Energy Partners L.P.
DYP	Duoyuan Printing, Inc.
DFT	DuPont Fabros Technology
DY	Dycom Industries Inc.
DYN	Dynegy Inc.
DX	Dynex Capital Inc.
DD	E. I. du Pont de Nemours and Company (DuPont)
SSP	The E.W. Scripps Company
EXP	Eagle Materials Inc.
EGP	Eastgroup Properties Inc.
EMN	Eastman Chemical Co.
EK	Eastman Kodak Co.
ETN	Eaton Corporation
EV	Eaton Vance Corporation
ECT	ECA Marcellus Trust I
ECL	Ecolab Inc.
EIX	Edison International
EDR	Education Realty Trust, Inc.
EW	Edwards Lifesciences Corp
EP	El Paso Corporation
EE	El Paso Electric Co.
LLY	Eli Lilly and Company
EFC	Ellington Financial LLC
EMC	EMC Corporation
EME	EMCOR Group, Inc.
EM	Emdeon Inc.
EMS	Emergency Medical Services Corporation
EBS	Emergent BioSolutions Inc.
ESC	Emeritus Corporation
EMR	Emerson Electric Co.
EDE	Empire District Electric Co.
EIG	Employers Holdings, Inc.
ELX	Emulex Corporation
EEQ	Enbridge Energy Management, L.L.C.
EEP	Enbridge Energy Partners, L.P.
ENB	Enbridge, Inc.
ECA	EnCana Corporation
ENP	Encore Energy Partners LP
END	Endeavour International Corporation
ENH	Endurance Specialty Holdings Ltd.
EGN	Energen Corporation
ENR	Energizer Holdings, Inc.
EPL	Energy Partners, Ltd.
ETE	Energy Transfer Equity, L.P.
ETP	Energy Transfer Partners, L.P.
ES	EnergySolutions, Inc.
ERF	Enerplus Corporation
ENS	EnerSys
EBF	Ennis, Inc.
NPO	EnPro Industries, Inc.
ETM	Entercom Communications Corporation
ETR	Entergy Corporation
EPD	Enterprises Products Partners L.P
EPR	Entertainment Properties Trust
EVC	Entravision Communications Corporation
ENV	Envestnet, Inc.
ENZ	Enzo Biochem, Inc.
EOG	EOG Resources, Inc.
EQT	EQT Corporation
EQU	Equal Energy Ltd.
EFX	Equifax Inc.
ELS	Equity Lifestyle Properties, Inc.
EQY	Equity One Inc.
EQR	Equity Residential
ESE	Esco Techologies Inc.
ESS	Essex Property Trust, Inc.
EL	Estee Lauder Companies Inc.
ESL	Esterline Technologies Corporation
ETH	Ethan Allen Interiors Inc.
EVR	Evercore Partners Inc.
RE	Everest Re Group Ltd.
EXAM	ExamWorks Group, Inc.
EXM	Excel Maritime Carriers Ltd.
EXL	Excel Trust, Inc.
XCO	EXCO Resources, Inc.
EXC	Exelon Corporation
EXPR	Express, Inc.
EXH	Exterran Holdings, Inc.
EXR	Extra Space Storage, Inc.
XOM	Exxon Mobil Corporation
FNB	F.N.B. Corporation
FN	Fabrinet
FDS	FactSet Research Systems Inc.
FICO	Fair Isaac Corporation
FCS	Fairchild Semiconductor Corporation
FDO	Family Dollar Stores Inc.
FFG	FBL Financial Group Inc.
AGM	Federal Agricultural Mortgage Corporation
FRT	Federal Realty Investment Trust
FSS	Federal Signal Corporation
FII	Federated Investors Inc.
FDX	FedEx Corporation
ADY	Feihe International, Inc.
FCH	FelCor Lodging Trust
FGP	Ferrellgas Partners L.P
FOE	Ferro Corporation
FNF	Fidelity National Financial Inc.
FISWD	Fidelity National Information Services, Inc.
FAC	First Acceptance Corporation
FAF	First American Financial Corporation
FBP	First BanCorp
FCF	First Commonwealth Financial Corporation
FHN	First Horizon National Corporation
FR	First Industrial Realty Trust, Inc.
AG	First Majestic Silver Corp.
FMD	The First Marblehead Corporation
FMR	First Mercury Financial Corporation
FPO	First Potomac Realty Trust
FRC	First Republic Bank
FE	FirstEnergy Corp
FVE	Five Star Quality Care, Inc.
FBC	Flagstar Bancorp, Inc.
FSR	Flagstone Reinsurance Holdings, S.A.
FLT	Fleetcor Technologies, Inc.
FTK	Flotek Industries, Inc.
FLO	Flowers Foods, Inc.
FLS	Flowserve Corporation
FLR	Fluor Corporation
FMC	FMC Corporation
FTI	FMC Technologies, Inc.
FL	Foot Locker, Inc.
F	Ford Motor Company
FCEB	FOREST CITY ENTERPRISES INC
FCEA	Forest City Enterprises, Inc.
FRX	Forest Laboratories, Inc.
FST	Forest Oil Corporation
FOR	Forestar Group Inc.
FRF	Fortegra Financial Corporation
FIG	Fortress Investment Group LLC
FO	Fortune Brands, Inc.
FC	Franklin Covey Company
BEN	Franklin Resources Inc.
FCX	Freeport-McMoRan Copper & Gold Inc.
FDP	Fresh Del Monte Produce Inc.
FTR	Frontier Communications Corporation
FTO	Frontier Oil Corporation
FRO	Frontline Ltd.
FCN	FTI Consulting, Inc.
FRM	Furmanite Corporation
FBN	Furniture Brands International, Inc.
FF	FutureFuel Corp.
FXCM	FXCM Inc.
GCAP	GAIN Capital Holdings, Inc.
GBL	Gamco Investors, Inc.
GME	GameStop Corp.
GCI	Gannett Co., Inc.
GPS	The Gap, Inc.
GDI	Gardner Denver Inc.
IT	Gartner  Inc.
GMT	Gatx Corporation
GET	Gaylord Entertainment Co.
GNK	Genco Shipping & Trading Limited
GY	Gencorp Inc
GNRC	Generac Holdings Inc.
BGC	General Cable Corporation
GD	General Dynamics Corporation
GE	General Electric Company
GGP	General Growth Properties
GMR	General Maritime Corporation
GIS	General Mills, Inc.
GM	General Motors Company
GSI	General Steel Holdings, Inc.
GCO	Genesco Inc.
GWR	Genesee & Wyoming, Inc.
GEN	Genon Energy, Inc.
G	Genpact Limited
GPC	Genuine Parts Company
GNW	Genworth Financial, Inc.
GEOWI	Geo Group, Inc.
GGC	Georgia Gulf Corporation
GRB	Gerber Scientific Inc.
GFC	Gerova Financial Group, Ltd.
GTY	Getty Realty Corp.
GFIG	GFI Group Inc.
GIL	Gildan Activewear Inc.
GLT	Glatfelter
GLG	GLG Partners, Inc.
GRT	Glimcher Realty Trust
GCA	Global Cash Access Holdings
GGS	Global Geophysical Services, Inc.
GLP	Global Partners LP
GPN	Global Payments Inc.
GSL	Global Ship Lease, Inc
GMXR	GMX Resources Inc.
GG	Goldcorp Inc.
GS	Goldman Sachs Group Inc.
GR	Goodrich Corporation
GDP	Goodrich Petroleum Corporation
GT	Goodyear Tire & Rubber Co.
GOV	Government Properties Income Trust
GPX	GP Strategies Corporation
GGG	Graco Inc.
GTI	Graftech International, Ltd.
GRM	Graham Packaging Company
GKK	Gramercy Capital Corp.
GVA	Granite Construction, Inc.
GPK	Graphic Packaging Holding Company
GTN	Gray Television, Inc.
GTNA	Gray Television, Inc.
GAP	The Great Atlantic & Pacific Tea Company, Inc.
GNI	Great Northern Iron Ore Properties
GXP	Great Plains Energy Inc.
GB	Greatbatch, Inc.
GDOT	Green Dot Corporation
GBX	The Greenbrier Companies, Inc.
GHL	Greenhill & Co., Inc.
GEF	Greif, Inc.
GEFB	Greif, Inc.
GFF	Griffon Corporation
GPI	Group 1 Automotive Inc.
GBE	Grubb & Ellis Company
GES	Guess?, Inc.
GOF	Guggenheim Strategic Opportunities Fund Common Shares
GLF	GulfMark Offshore, Inc.
HRB	H&R Block Inc.
HNZ	H. J. Heinz Company
FUL	H.B. Fuller Company
HAE	Haemonetics Corp
HAL	Halliburton Company
HBI	Hanesbrands Inc.
HGR	Hanger Orthopedic Group Inc.
THG	The Hanover Insurance Group
HRG	Harbinger Group Inc.
HOG	Harley-Davidson, Inc.
HAR	Harman International Ind. Inc.
HRS	Harris Corporation
HWD	Harry Winston Diamond Corporation
HSC	Harsco Corporation
HHS	Harte Hanks Inc.
HIG	Hartford Financial Services Group Inc.
HNR	Harvest Natural Resources, Inc.
HTS	Hatteras Financial Corp.
HVT	Haverty Furniture Companies Inc.
HE	Hawaiian Electric Industries Inc.
HCA	HCA Holdings, Inc.
HCC	HCC Insurance Holdings, Inc.
HCP	HCP, Inc.
HW	Headwaters Incorporated
HCN	Health Care REIT, Inc.
HMA	Health Management Associates Inc.
HNT	Health Net, Inc.
HR	Healthcare Realty Trust Inc.
HLS	HealthSouth Corporation
HS	HealthSpring, Inc.
HPY	Heartland Payment Systems, Inc.
HEK	Heckmann Corporation
HL	Hecla Mining Co.
HEI	HEICO Corporation
HLX	Helix Energy Solutions Group, Inc.
HP	Helmerich & Payne Inc.
HLF	Herbalife Ltd.
HT	Hersha Hospitality Trust
HSY	The Hershey Company
HTZ	Hertz Global Holdings, Inc.
HES	Hess Corporation
HEW	Hewitt Associates
HPQ	Hewlett Packard Co.
HXL	Hexcel Corporation
HF	HFF, Inc.
HGG	hhgregg, Inc.
ONE	Higher One Holdings, Inc.
HIW	Highwoods Properties Inc.
HIL	Hill International, Inc.
HRC	Hill-Rom Holdings, Inc.
HI	Hillenbrand, Inc.
HTH	Hilltop Holdings Inc.
HNI	HNI Corporation
HOC	Holly Corporation
HEP	Holly Energy Partners, L.P.
HD	Home Depot, Inc.
HME	Home Properties, Inc.
HON	Honeywell International, Inc.
HMN	Horace Mann Educators Corporation
HRZ	Horizon Lines, Inc.
HRL	Hormel Foods Corporation
HOS	Hornbeck Offshore Services, Inc.
HSP	Hospira, Inc.
HPT	Hospitality Properties Trust
HST	Host Hotels & Resorts, Inc.
HOV	Hovnanian Enterprises, Inc.
HHC	The Howard Hughes Corporation
HUB.B	Hubbell Inc.
HUBA	Hubbell Inc.
HBM	HudBay Minerals Inc.
HPP	Hudson Pacific Properties, Inc.
HGT	Hugoton Royalty Trust
HUM	Humana Inc.
HII	Huntington Ingalls Industries, Inc.
HUN	Huntsman Corporation
H	Hyatt Hotels Corporation
HYC	Hypercom Corporation
IAG	IAMGOLD Corporation
IEP	Icahn Enterprises L.P.
IDA	Idacorp Inc.
IAR	Idearc Inc.
IEX	IDEX Corporation
IDT	IDT Corporation
BIN	IESI-BFC Ltd.
IHS	IHS Inc.
ITW	Illinois Tool Works Inc.
IMN	Imation Corporation
IMAX	IMAX Corporation
IMP	Imperial Capital Bancorp, Inc.
IFT	Imperial Holdings, Inc.
IHC	Independence Holding Company
NRGY	Inergy, L.P.
IR	Ingersoll-Rand plc
IM	Ingram Micro Inc.
IRC	Inland Real Estate Corporation
IPHI	Inphi Corporation
NSP	Insperity, Inc.
TEG	Integrys Energy Group, Inc.
ICE	IntercontinentalExchange, Inc.
IBI	Interline Brands, Inc.
IN	Intermec, Inc.
IBM	International Business Machines Corporation
ICO	International Coal Group, Inc.
IFF	International Flavors & Fragrances Inc.
IGT	International Game Technology
IP	International Paper Co.
IRF	International Rectifier Corporation
ISH	International Shipholding Corporation
IPG	Interpublic Group of Companies Inc.
INXN	InterXion Holding N.V.
IL	IntraLinks Holdings, Inc.
IPI	Intrepid Potash, Inc.
IVC	Invacare Corporation
IVZ	Invesco Ltd.
IVR	Invesco Mortgage Capital Inc.
VLT	Invesco Van Kampen High Income Trust II
ITG	Investment Technology Group Inc.
IO	Ion Geophysical Corporation
IRM	Iron Mountain Inc.
SFI	iStar Financial Inc.
ITC	ITC Holdings Corp.
ITT	ITT Corporation
ESI	ITT Educational Services Inc.
IVN	Ivanhoe Mines Ltd.
JCG	J. Crew Group, Inc.
SJM	J. M. Smucker Company
JCP	J.C. Penney Company Inc.
JBL	Jabil Circuit Inc.
JTX	Jackson Hewitt Tax Service Inc.
JEC	Jacobs Engineering Group Inc.
JNS	Janus Capital Group Inc.
JAH	Jarden Corporation
JEF	Jefferies Group Inc.
JMP	JMP Group Inc.
JAS	Jo-Ann Stores, Inc.
JBT	John Bean Technologies Corporation
JWA	John Wiley & Sons, Inc.
JNJ	Johnson & Johnson
JCI	Johnson Controls, Inc.
JNY	The Jones Group Inc.
JLL	Jones Lang Lasalle Inc.
JRN	Journal Communications, Inc.
JPM	JPMorgan Chase & Co.
JNPR	Juniper Networks
LRN	K12 Inc.
KAI	Kadant Inc.
KSU	Kansas City Southern
KS	KapStone Paper and Packaging Corporation
KAR	KAR Auction Services
KDN	Kaydon Corporation
KBH	KB Home
KBR	KBR, Inc.
KBW	KBW, Inc.
K	Kellogg Company
KEM	KEMET Corporation
KMT	Kennametal Inc.
KCP	Kenneth Cole Productions Inc.
KEG	Key Energy Services, Inc.
KEY	KeyCorp
KID	Kid Brands, Inc.
KRC	Kilroy Realty Corporation
KMB	Kimberly-Clark Corporation
KIM	Kimco Realty Corporation
KMP	Kinder Morgan Energy Partners L.P
KMR	Kinder Morgan Management, LLC
KMI	Kinder Morgan, Inc.
KND	Kindred Healthcare, Inc.
KCI	Kinetic Concepts, Inc.
KG	King Pharmaceuticals Inc.
KFS	Kingsway Financial Services Inc
KGC	Kinross Gold Corporation
KEX	Kirby Corporation
KRG	Kite Realty Group Trust
KFN	KKR Financial Holdings LLC
KCG	Knight Capital Group, Inc.
KNX	Knight Transportation, Inc.
KNL	Knoll, Inc.
KSS	Kohls Corporation
KOP	Koppers Holdings Inc.
KFY	Korn Ferry International
KFT	Kraft Foods Inc.
KRA	Kraton Performance Polymers, Inc.
KKD	Krispy Kreme Doughnuts, Inc.
KR	Kroger Co.
KRO	KRONOS Worldwide, Inc.
KVA	KV Pharmaceutical Co.
KVB	KV Pharmaceutical Co.
LLL	L 3 Communication Holdings Inc.
ID	L-1 Identity Solutions, Inc.
LZB	La-Z-Boy Incorporated
LH	Laboratory Corporation of America Holdings
LAB	Labranche & Co Inc.
LG	Laclede Group, Inc.
LDR	Landauer, Inc.
LNY	Landry's Restaurants, Inc.
LVS	Las Vegas Sands Corp.
LHO	Lasalle Hotel Properties
LAZ	Lazard Ltd.
LF	LeapFrog Enterprises Inc.
LEAWI	Lear Corporation
LEE	Lee Enterprises, Incorporated
LRP	Legacy Healthcare Properties Trust Inc.
LM	Legg Mason Inc.
LEG	Leggett & Platt Inc.
LPS	Lender Processing Services, Inc.
LEN	Lennar Corporation
LII	Lennox International Inc.
LUK	Leucadia National Corporation
LXP	Lexington Realty Trust
LXK	Lexmark International, Inc.
LRY	Liberty Property Trust
LTM	Life Time Fitness, Inc.
LTD	Limited Brands, Inc.
TVL	Lin TV Corp.
LNC	Lincoln National Corporation
LNN	Lindsay Corporation
LGF	Lions Gate Entertainment Corp.
LAD	Lithia Motors, Inc.
LYV	Live Nation Entertainment, Inc.
LIZ	Liz Claiborne Inc.
LMT	Lockheed Martin
L	Loews Corporation
LO	Lorillard, Inc.
LPX	Louisiana-Pacific Corporation
LOW	Lowe's Companies, Inc.
LSI	LSI Corporation
LTC	LTC Properties Inc.
LZ	Lubrizol Corporation
LUB	Luby's, Inc.
LL	Lumber Liquidators Holdings, Inc.
LDL	Lydall, Inc.
LYB	LyondellBasell Industries N.V.
MFW	M & F Worldwide Corporation
MTB	M&T Bank Corporation
MDC	M.D.C. Holdings, Inc.
MHO	M/I Homes, Inc.
TUC	Mac-Gray Corporation
MAC	Macerich Co.
CLI	Mack Cali Realty Corporation
MIC	Macquarie Infrastructure Company Trust
M	Macy's Inc.
MMP	Magellan Midstream Partners, L.P.
MGA	Magna International Inc.
MX	MagnaChip Semiconductor Corporation
MAG	Magnetek, Inc.
MHR	Magnum Hunter Resources Corporation
MFB	Maidenform Brands, Inc.
MAIN	Main Street Capital Corporation
MTW	Manitowoc Company, Inc.
MAN	Manpower Inc.
MFC	Manulife Financial Corporation
MRO	Marathon Oil Corporation
MCS	Marcus Corporation
MPX	Marine Products Corporation
HZO	Marinemax Inc.
MKL	Markel Corporation
MWE	MarkWest Energy Partners, L.P.
MAR	Marriott International, Inc.
MMC	Marsh & McLennan Companies Inc.
MI	Marshall & Ilsley Corporation
MSO	Martha Stewart Living Omnimedia, Inc.
MLM	Martin Marietta Materials Inc.
MAS	Masco Corporation
MSGY	Masergy Communications, Inc.
MEE	Massey Energy Co.
MTZ	MasTec, Inc.&nbsp;
MA	MasterCard Incorporated
MTRN	Materion Corporation
MAT	Mattel, Inc.
MLP	Maui Land & Pineapple Company, Inc.
MMS	MAXIMUS, Inc.
MXL	MaxLinear, Inc.
MBI	MBIA Inc.
MFE	McAfee, Inc.
MNI	The McClatchy Company
MKC	McCormick & Company, Inc.
MDRWI	McDermott International, Inc.
MCD	McDonald's Corporation
MHP	McGraw-Hill Companies Inc.
MCK	McKesson Corporation
MMR	McMoRan Exploration Co.
MDU	MDU Resources Group, Inc.
MJN	Mead Johnson Nutrition Company
MIG	Meadowbrook Insurance Group Inc.
MWV	MeadWestvaco Corporation
MHS	Medco Health Solutions, Inc.
MEG	Media General
MPW	Medical Properties Trust, Inc.
MRX	Medicis Pharmaceutical Corporation
MED	Medifast, Inc.
MD	Mednax, Inc.
MDT	Medtronic Inc.
WFR	MEMC Electronic Materials Inc.
MW	Men's Wearhouse Inc.
MRK	Merck & Co Inc.
MCY	Mercury General Corporation
MDP	Meredith Corporation
MTH	Meritage Homes Corporation
MTOR	Meritor, Inc.
MTR	Mesa Royalty Trust
MSB	Mesabi Trust
MPR	Met Pro Corporation
MUSA	Metals USA Holdings Corp.
MEI	Methode Electronics, Inc.
MET	MetLife, Inc.
PCS	MetroPCS Communications, Inc.
MTD	Mettler Toledo International Inc.
MF	MF Global Holdings Ltd.
MFA	MFA Financial, Inc.
MTG	MGIC Investment Corporation
MGM	MGM Resorts International
MIM	MI Developments Inc.
MAA	Mid America Apartment Communities Inc.
MDS	Midas Group Inc.
MLR	Miller Industries Inc.
MSA	Mine Safety Appliances Company
MTX	Minerals Technologies Inc.
MG	MISTRAS Group, Inc.
MOD	Modine Manufacturing Company
MHK	Mohawk Industries Inc.
MOH	Molina Healthcare, Inc.
TAP	Molson Coors Brewing Company
MCP	Molycorp, Inc.
MGI	MoneyGram International, Inc.
MNR	Monmouth Real Estate Investment Corporation
MON	Monsanto Company
MWW	Monster Worldwide, Inc.
MRH	Montpelier Re Holdings Ltd.
MCO	Moody's Corporation
MOG.A	Moog Inc.
MS	Morgan Stanley
MRT	Morton's Restaurant Group, Inc.
MOS	The Mosaic Company
MMI	Motorola Mobility Holdings, Inc.
MSI	Motorola Solutions, Inc.
MOV	Movado Group, Inc.
MPG	MPG Office Trust, Inc.
MSM	Msc Industries Direct Co Inc.
MSCI	MSCI, Inc.
MLI	Mueller Inds Inc
MWA	Mueller Water Products, Inc.
MUR	Murphy Oil Corporation
MVO	MV Oil Trust
MYE	Myers Industries, Inc.
NBR	Nabors Industries Ltd.
NC	NACCO Industries Inc.
NLC	Nalco Holding Company
NTE	Nam Tai Electronics, Inc.
NFP	National Financial Partners Corp.
NFG	National Fuel Gas Co.
NHI	National Health Investors Inc.
NOV	National Oilwell Varco, Inc.&nbsp;
NPK	National Presto Industries Inc.
NNN	National Retail Properties, Inc.
NSM	National Semiconductor Corporation
NHP	Nationwide Health Properties Inc.
NRP	Natural Resource Partners LP
NLS	Nautilus, Inc.
NCI	Navigant Consulting, Inc.
NNA	Navios Maritime Acquisition Corporation
NM	Navios Maritime Holdings Inc.
NAV	Navistar International Corporation
NTY	NBTY, Inc.
NCS	NCI Building Systems Inc.
NCR	NCR Corporation
NP	Neenah Paper, Inc.
NNI	Nelnet, Inc.
NPTN	NeoPhotonics Corporation
N	NetSuite Inc.
NSR	NeuStar, Inc.
NJR	New Jersey Resources Corporation
PLAA	New Playboy Inc.
NWY	New York & Company, Inc.
NYB	New York Community Bancorp, Inc.
NYT	New York Times Co.
NAL	NewAlliance Bancshares, Inc.
NCT	Newcastle Investment Corp.
NWL	Newell Rubbermaid Inc.
NFX	Newfield Exploration Co.
NEU	NewMarket Corporation
NEM	Newmont Mining Corporation (Holding Company)
NR	Newpark Resources Inc.
NXY	Nexen, Inc.
NEE	NextEra Energy, Inc.
GAS	Nicor Inc.
NLSN	Nielsen Holdings N.V.
NKE	Nike Inc.
NKA	Niska Gas Storage Partners LLC
NI	NiSource Inc.
NL	NL Industries Inc.
NE	Noble Corporation
NBL	Noble Energy, Inc.
NOR	Noranda Aluminum Holding Corporation
NAT	Nordic American Tanker Shipping Limited
NDZ	Nordion Inc.
JWN	Nordstrom Inc.
NSC	Norfolk Southern Corporation
NOA	North American Energy Partners Inc.
NRT	North European Oil Royalty Trust
NU	Northeast Utilities Systems
NOC	Northrop Grumman Corporation
NRF	Northstar Realty Finance Corp.
NWN	Northwest Natural Gas Company
NWE	NorthWestern Corporation
NRG	NRG Energy, Inc.
NST	NSTAR
NUS	Nu Skin Enterprises Inc.
NUE	Nucor Corporation
NS	NuStar Energy L.P.
NSH	NuStar GP Holdings, LLC
NVE	NV Energy, Inc.
NVR	NVR, Inc.
NYX	NYSE Euronext
OAS	Oasis Petroleum Inc.
OXY	Occidental Petroleum Corporation
OII	Oceaneering International Inc.
OZM	Och-Ziff Capital Management Group LLC
OCN	Ocwen Financial Corporation
ODP	Office Depot Inc.
OMX	OfficeMax Incorporated
OGE	OGE Energy Corp.
ODC	Oil Dri Corporation of America
OIS	Oil States International, Inc
ONB	Old National Bancorp
ORI	Old Republic International Corporation
OLN	Olin Corporation
OMG	OM Group, Inc.
OHI	Omega Healthcare Investors, Inc
OME	Omega Protein Corporation
OCR	Omnicare Inc.
OMC	Omnicom Group Inc.
OMN	OMNOVA Solutions Inc.
OLP	One Liberty Properties, Inc.
OB	OneBeacon Insurance Group, LTD
OKS	Oneok Partners, L.P.
OKE	ONEOK, Inc.
OPY	Oppenheimer Holdings Inc.
ORB	Orbital Sciences Corporation
OWW	Orbitz Worldwide, Inc.
OEH	Orient-Express Hotels Ltd.
OFG	Oriental Financial Group, Inc.
ORN	Orion Marine Group, Inc.
ORA	Ormat Technologies, Inc.
OSK	Oshkosh Corporation
OSG	Overseas Shipholding Group Inc.
OMI	Owens & Minor Inc.
OC	Owens Corning
OI	Owens Illinois Inc.
OXM	Oxford Industries Inc.
OXF	Oxford Resource Partners, LP
PNG	PAA Natural Gas Storage, L.P.
PCE	Pacific Office Properties Trust, Inc.
PKG	Packaging Corporation Of America
PLL	Pall Corporation
PHX	Panhandle Oil and Gas Inc
PRX	Par Pharmaceutical Companies, Inc.
PAR	PAR Technology Corporation
PRGN	Paragon Shipping Inc.
PKE	Park Electrochemical Corporation
PKD	Parker Drilling Company
PH	Parker Hannifin Corporation
PKY	Parkway Properties Inc.
PRE	PartnerRe Ltd.
PCX	Patriot Coal Corporation
PMG	Patriot Risk Management, Inc.
BTU	Peabody Energy Corporation
PEB	Pebblebrook Hotel Trust
PGH	Pengrowth Energy Trust
PVA	Penn Virginia Corporation
PVR	Penn Virginia Resource Partners, L.P.
PWE	Penn West Petroleum Ltd.
PEI	Pennsylvania Real Estate Investment Trust
PMT	PennyMac Mortgage Investment Trust
PAG	Penske Automotive Group, Inc.
PNR	Pentair Inc.
PBY	Pep Boys Manny Moe & Jack
POM	Pepco Holdings, Inc.
PEP	PepsiCo Inc.
PKI	PerkinElmer, Inc.
PBT	Permian Basin Royalty Trust
HK	Petrohawk Energy Corporation
PQ	Petroquest Energy, Inc.
PFE	Pfizer Inc.
PCG	PG &E Corporation
PMC	PharMerica Corporation
PHH	PHH Corporation
PM	Philip Morris International Inc.
PVH	Phillips-Van Heusen Corporation
PNX	The Phoenix Companies, Inc.
PNY	Piedmont Natural Gas Co Inc.
PDM	Piedmont Office Realty Trust
PIR	Pier 1 Imports Inc.
PIKE	Pike Electric Corporation
PPC	Pilgrim's Pride Corporation
PNK	Pinnacle Entertainment, Inc.
PNW	Pinnacle West Capital Corporation
PXD	Pioneer Natural Resources Company
PSE	Pioneer Southwest  Energy Partners L.P.
PJC	Piper Jaffray Companies
PBI	Pitney Bowes Inc.
PAA	Plains All American Pipeline, L.P.
PXP	Plains Exploration & Production Company
PLT	Plantronics Inc.
PTP	Platinum Underwriters Holdings, Ltd.
PLA	Playboy Enterprises, Inc.
PCL	Plum Creek Timber Company, Inc.
PMI	The Pmi Group Inc.
PNC	PNC Financial Services Group,The
PNM	PNM Resources, Inc.
PII	Polaris Industries Inc.
RL	Polo Ralph Lauren Corporation
POL	PolyOne Corporation
PPO	Polypore International, Inc.
POR	Portland General Electric Company
PPS	Post Properties Inc.
POT	Potash Corporation of Saskatchewan Inc.
PPG	PPG Industries, Inc.
PPL	PPL Corporation
PX	Praxair, Inc.
PPD	Pre-Paid Legal Services Inc.
PCP	PRECISION CASTPARTS CORP
PDS	Precision Drilling Trust
PGI	Premiere Global Services, Inc.
PBH	Prestige Brands Holdings, Inc.
PDE	Pride International, Inc.
PRM	Primedia Inc.
PRI	Primerica, Inc.
PRS	Primus Guaranty, Ltd.
PFG	Principal Financial Group, Inc.
PRA	ProAssurance Corporation
PG	Procter & Gamble Co.
PGN	Progress Energy, Inc.
PGR	Progressive Corporation
PLD	Prologis
PRO	PROS Holdings, Inc.
PL	Protective Life Corporation
PVX	Provident Energy Ltd.
PFS	Provident Financial Services, Inc.
PRU	Prudential Financial, Inc.
PSB	PS Business Parks, Inc.
PEG	Public Service Enterprise Group Inc.
PSA	Public Storage
PULS	Pulse Electronics Corporation
PHM	PulteGroup, Inc.
PZN	Pzena Investment Management, Inc.
QEP	QEP Resources, Inc.
QXM	Qiao Xing Mobile Communication Co., Ltd.
QRE	QR Energy, LP
QUAD	Quad/Graphics, Inc.
KWR	Quaker Chemical Corporation
NX	Quanex Building Products Corporation
PWR	Quanta Services Inc.
QTM	Quantum Corporation
DGX	Quest Diagnostics Incorporated
STR	Questar Corporation
KWK	Quicksilver Resources Inc.
ZQK	Quiksilver, Inc.
Q	Qwest Communications International Inc.
RAX	Rackspace Hosting, Inc.
RDN	Radian Group, Inc.
RSH	RadioShack Corporation
RA	RailAmerica, Inc.
RAS	RAIT Financial Trust
RAH	Ralcorp Holding Inc.
RPT	Ramco Gershenson Properties Trust
RRC	Range Resources Corporation
RJF	Raymond James Financial Inc.
RYN	Rayonier Inc.
RTN	Raytheon Company
RLD	RealD Inc.
O	Realty Income Corporation
RHT	Red Hat, Inc.
RLH	Red Lion Hotels Corporation
FRZ	Reddy Ice Holdings, Inc.
RWT	Redwood Trust Inc
RGC	Regal Entertainment Group
RBC	REGAL-BELOIT CORPORATION
REG	Regency Centers Corporation
RF	Regions Financial Corporation
RGS	Regis Corporation
RHB	Rehabcare Group Inc.
RGA	Reinsurance Group of America, Incorporated
RS	Reliance Steel & Aluminum Co.
RNR	RenaissanceRe Holdings Ltd.
RSG	Republic Services, Inc.
RMD	ResMed Inc.
REN	Resolute Energy Corporation
RSO	Resource Capital Corporation
RVI	Retail Ventures, Inc.
REV	Revlon, Inc.
REX	Rex American Resources Corporation
RAI	Reynolds American, Inc.
RNO	Rhino Resource Partners LP
RBA	Ritchie Bros Auctioneers Inc.
RAD	Rite Aid Corporation
RLI	RLI Corp
RRTS	Roadrunner Transportation Systems, Inc.
RBN	Robbins & Myers, Inc.
RHI	Robert Half International Inc.
RKT	Rock Tenn Co.
ROK	Rockwell Automation, Inc.
COL	Rockwell Collins, Inc.
ROC	Rockwood Holdings, Inc.
RCI	Rogers Communications Inc.
ROG	Rogers Corporation
ROL	Rollins Inc.
ROP	Roper Industries Inc.
RST	Rosetta Stone Inc.
RDC	Rowan Companies Inc.
RY	Royal Bank of Canada
RCL	Royal Caribbean Cruises Ltd.
RES	RPC Inc.
RPM	RPM International Inc.
RRR	RSC Holdings, Inc.
RTI	RTI International Metals Inc.
RT	Ruby Tuesday, Inc.
RDK	Ruddick Corporation
R	Ryder System, Inc.
RYI	Ryerson Holding Corporation
RYL	Ryland Group Inc.
SBR	Sabine Royalty Trust
SB	Safe Bulkers Inc.
SFE	Safeguard Scientifics, Inc.
SWY	Safeway Inc.
SAI	SAIC, Inc.
SKS	Saks Incorporated
CRM	salesforce.com, inc.
SBH	Sally Beauty Holdings, Inc.
SJT	San Juan Basin Royalty Trust
SD	SandRidge Energy, Inc.
SLE	Sara Lee Corp.
SHS	Sauer-Danfoss Inc.
BFS	Saul Centers Inc.
SCG	SCANA Corporation
SGK	Schawk Inc.
WNI	Schiff Nutrition International, Inc.
SLB	Schlumberger Limited
SWM	Schweitzer Mauduit International, Inc.
STNG	Scorpio Tankers Inc.
SMG	The Scotts Miracle-Gro Company
SNI	Scripps Networks Interactive, Inc.
SBX	SeaBright Holdings, Inc.
CKH	SEACOR Holdings Inc.
BOX	Seacube Container Leasing Ltd.
SDRL	Seadrill Limited
SEE	Sealed Air Corporation
ZZ	Sealy Corporation
SSW	Seaspan Corporation
SEM	Select Medical Holdings Corporation
SEMG	SemGroup Corporation
SRE	Sempra Energy
SNH	Senior Housing Properties Trust
ST	Sensata Technologies Holding N.V.
SXT	Sensient Technologies Corporation
SCI	Service Corporation International
SFN	SFN Group, Inc.
SJR	Shaw Communications Inc.
SHAW	Shaw Group Inc.
SHW	Sherwin Williams Co.
SFL	Ship Finance International Limited
SIG	Signet Jewelers Limited
SLW	Silver Wheaton Corp.
SPG	Simon Property Group, Inc.
SSD	Simpson Manufacturing Co., Inc.
SIX	Six Flags Entertainment Corporation
SJW	SJW Corp.
SKX	SKECHERS USA, Inc.
SKH	Skilled Healthcare Group, Inc.
SKY	Skyline Corporation
SLG	SL Green Realty Corporation
SLM	SLM Corporation
SM	SM Energy Company
SFD	Smithfield Foods Inc.
SSCC	Smurfit-Stone Container Corporation
SNA	Snap On Inc.
SWI	SolarWinds, Inc.
SLH	Solera Holdings, Inc.
SOA	Solutia Inc.
SAH	Sonic Automotive Inc.
SON	Sonoco Products Co.
BID	Sotheby's
SJI	South Jersey Industries Inc.
SO	Southern Company
SCCO	Southern Copper Corporation
SUG	Southern Union Co.
LUV	Southwest Airlines Co.
SWX	Southwest Gas Corporation
SWN	Southwestern Energy Co.
SSS	Sovran Self Storage Inc.
SEH	Spartech Corporation
SPA	Sparton Corporation
SE	Spectra Energy Corp
SEP	Spectra Energy Partners, LP
SPB	Spectrum Brand Holdings, Inc.
TRK	Speedway Motorsports, Inc.
SPR	Spirit AeroSystems Holdings, Inc.
S	Sprint Nextel Corporation
SPW	SPX Corporation
SRX	SRA International, Inc.
JOE	St Joe Co.
STJ	St. Jude Medical, Inc.
SSI	Stage Stores, Inc.
SFG	StanCorp Financial Group, Inc.
SMP	Standard Motor Products, Inc.
SPF	Standard Pacific Corp.
SR	Standard Register
SXI	Standex International Corporation
SWK	Stanley Black & Decker, Inc.
STN	Stantec Inc.
SGU	Star Gas Partners LP.
SCX	Starrett L S Co.
SRT	Startek Inc.
HOT	Starwood Hotel & Resorts Worldwide, Inc.
STWD	Starwood Property Trust, Inc.
STT	State Street Corporation
SCS	Steelcase Inc.
LVB	Steinway Musical Instruments, Inc.
SCL	Stepan Co.
STE	Steris Corporation
STL	Sterling Bancorp
STC	Stewart Information Services Corporation
SF	Stifel Financial Corporation
SWC	Stillwater Mining Company
SGY	Stone Energy Corp
SRI	Stoneridge, Inc.
STRI	STR Holdings, Inc.
BEE	Strategic Hotel & Resorts, Inc.
SYK	Stryker Corporation
RGR	Sturm, Ruger & Company Inc.
SPH	Suburban Propane Partners LP
INN	Summit Hotel Properties, Inc.
SUI	Sun Communities Inc.
SLF	Sun Life Financial, Inc.
SU	Suncor Energy Inc.
SUN	Sunoco Inc.
SXL	Sunoco Logistics Partners, L.P.
SRZ	Sunrise Senior Living, Inc.
SHO	Sunstone Hotel Investors, Inc.
STI	Suntrust Banks Inc.
SPN	Superior Energy Services, Inc.
SUP	Superior Industries International Inc.
SVU	SUPERVALU INC.
SFY	Swift Energy Co.
SWFT	Swift Transportation Company
SWS	SWS Group, Inc.
SYA	Symetra Financial Corporation
SMA	Symmetry Medical Inc.
SVR	Syniverse Holdings, Inc.
SNX	SYNNEX Corporation
SNV	Synovus Financial Corp.
SYY	SYSCO Corporation
SYX	Systemax Inc.
TAL	TAL International Group
TLB	The Talbots, Inc.
TLM	Talisman Energy Inc.
SKT	Tanger Factory Outlet Centers, Inc.
TRGP	Targa Resources Corp.
NGLS	Targa Resources Partners LP
TGT	Target Corporation
TCO	Taubman Centers, Inc.
TCB	TCF Financial Corporation
TEL	TE Connectivity Ltd.
TMH	Team Health Holdings, Inc.
TCK	Teck Resources Limited
TE	TECO Energy, Inc.
TK	Teekay Corporation
TNK	Teekay Tankers Ltd
TRC	Tejon Ranch Co.
TDY	Teledyne Technologies Inc
TFX	Teleflex Inc.
TDS	Telephone and Data Systems, Inc.
TU	TELUS Corporation
TIN	Temple-Inland Inc.
TPX	Tempur-Pedic International, Inc.
THC	Tenet Healthcare Corporation
TNC	Tennant Company
TEN	Tenneco Inc.
TDC	Teradata Corporation
TER	Teradyne Inc.
TEX	Terex Corporation
TNH	Terra Nitrogen Co. LP
TTT	Terra Nova Royalty Corporation
TRNO	Terreno Realty Corporation
TSO	Tesoro Corporation
TTI	Tetra Technologies Inc.
TXI	Texas Industries
TXN	Texas Instruments Inc.
TPL	Texas Pacific Land Trust
TGH	Textainer Group Holdings Limited
TXT	Textron Inc
TGX	Theragenics Corporation
TMO	Thermo Fisher Scientific Inc.
TNB	Thomas & Betts Corporation
TC	Thompson Creek Metals Company Inc.
TRI	Thomson Reuters Corporation
THO	Thor Industries, Inc.
TDW	Tidewater, Inc.
TIF	Tiffany & Co.
THI	Tim Hortons Inc.
TBL	Timberland Co.
TWC	Time Warner Cable Inc.
TWX	Time Warner Inc.
TKR	Timken Co.
TWI	Titan International Inc.
TIE	Titanium Metals Corporation
TJX	TJX Companies Inc.
TNS	TNS, Inc.
TOD	Todd Shipyards Corporation
TOL	Toll Brothers Inc.
TR	Tootsie Roll Industries Inc.
TRU	Torch Energy Royalty Trust
TMK	Torchmark Corporation
TTC	Toro Company
TD	Toronto-Dominion Bank
TSS	Total System Services, Inc.
TOWR	Tower International, Inc.
TW	Towers Watson & Co.
TAC	TransAlta Corporation
TRH	Transatlantic Holdings Inc.
TRP	TransCanada Corporation
TCI	Transcontinental Realty Investors Inc.
TDG	TransDigm Group Incorporated
TLP	Transmontaigne Partners L.P.
RIG	Transocean Ltd.
TRV	The Travelers Companies, Inc.
TRR	TRC Companies, Inc.
TG	Tredegar Corporation
THS	TreeHouse Foods, Inc.
TREX	Trex, Inc.
TRY	Triarc Companies Inc.
TRN	Trinity Industries Inc.
GTS	Triple-S Management Corporation
TGI	Triumph Group Inc.
TBI	TrueBlue, Inc.
TRW	TRW Automotive Holdings Corp.
TNP	Tsakos Energy Navigation Limited
TUP	Tupperware Brands Corporation
TPC	Tutor Perini Corporation
TWO	Two Harbors Investment Corp.
TYC	Tyco International Ltd.
TYL	Tyler Technologies, Inc.
TSN	Tyson Foods Inc.
YSI	U-Store-It Trust
UBS	UBS AG
UDR	UDR, Inc.
UGI	UGI Corporation
UIL	UIL Holdings Corporation
UPL	Ultra Petroleum Corp.
UA	Under Armour, Inc.
UFI	Unifi Inc
UNF	Unifirst Corporation
UNP	Union Pacific Corporation
UNS	UniSource Energy Corporation
UIS	Unisys Corporation
UNT	Unit Corporation
UAL	United Continental Holdings, Inc
UPS	United Parcel Service, Inc.
URI	United Rentals, Inc.
USM	United States Cellular Corporation
X	United States Steel Corporation
UTX	United Technologies Corporation
UNH	UnitedHealth Group Inc.
UTL	Unitil Corporation
UTR	Unitrin, Inc.
UAM	Universal American Corporation
UVV	Universal Corporation
UHT	Universal Health Realty Income Trust
UHS	Universal Health Services Inc.
UTI	Universal Technical Institute
UNM	Unum Group
URS	URS Corporation
UBA	Urstadt Biddle Properties Inc.
UBP	Urstadt Biddle Properties Inc.
LCC	US Airways Group, Inc.
USB	US Bancorp
USNA	USANA Health Sciences, Inc
USU	USEC Inc.
USG	USG Corporation
EGY	VAALCO Energy, Inc.
MTN	Vail Resorts, Inc.
VCI	Valassis Communications
VRX	Valeant Pharmaceuticals International, Inc.
VLO	Valero Energy Corporation
VHI	Valhi, Inc.
VRWD	Validus Holdings, Ltd.
VLY	Valley National Bancorp
VMI	Valmont Industries, Inc.
VAL	The Valspar Corporation
VNR	Vanguard Natural Resources, LLC
VAR	Varian Medical Systems, Inc.
VGR	Vector Group Ltd.
VVC	Vectren Corp
VQ	Venoco, Inc.
VTR	Ventas Inc.
PAY	VeriFone Systems, Inc.
VZWI	Verizon Communications
VRS	Verso Paper Corp.
VFC	VF Corporation
VIA.B	Viacom Inc.
VVI	Viad Corp
V	Visa Inc.
VSH	Vishay Intertechnology Inc.
VPG	Vishay Precision Group, Inc.
VC	Visteon Corporation
VSI	Vitamin Shoppe, Inc.
VMW	VMware, Inc.
VOL	Volt Information Sciences, Inc.
VG	Vonage Holdings Corp.
VNO	Vornado Realty Trust
VMC	Vulcan Materials Company
WTI	W&T Offshore, Inc.
WPC	W. P. Carey and Co. LLC
WRB	W.R. Berkley Corporation
GRA	W.R. Grace & Co.
GWW	W.W. Grainger, Inc.
WNC	Wabash National Corporation
WBC	WABCO Holdings Inc.
WAB	Wabtec Corporate
WDR	Waddell & Reed Financial Inc
WMT	Wal-Mart Stores, Inc.
WAG	Walgreens
WD	Walker & Dunlop, Inc.
DIS	The Walt Disney Company
WLT	Walter Energy, Inc.
WRC	The Warnaco Group, Inc.
WMG	Warner Music Group Corp.
WPO	Washington Post Co.
WRE	Washington Real Estate Investment
WCN	Waste Connections, Inc.
WM	Waste Management, Inc.
WAT	Waters Corporation
WSO	Watsco, Inc.
WPI	Watson Pharmaceuticals Inc.
WTS	Watts Water Technologies, Inc.
WPP	Wausau Paper Corp.
WFT	Weatherford International, Ltd.
WBS	Webster Financial Corporation
WTW	Weight Watchers International, Inc.
WRI	Weingarten Realty Investors
WMK	Weis Markets Inc
WCG	WellCare Health Plans, Inc.
WLP	Wellpoint, Inc.
WFC	Wells Fargo & Co.
EOD	Wells Fargo Advantage Global Dividend Opportunity Fund
WEN	Wendy's/Arby's Group, Inc.
WCC	WESCO International, Inc.
WST	West Pharmaceutical Services Inc.
WR	Westar Energy, Inc.
WAL	Western Alliance Bancorporation
WDC	Western Digital Corporation
WNR	Western Refining, Inc.
WU	The Western Union Company
WLK	Westlake Chemical Corporation
WHG	Westwood Holdings Group, Inc.
WY	Weyerhaeuser Co.
WGL	WGL Holdings, Inc.
WHR	Whirlpool Corporation
WTM	WHITE MOUNT INS GRP LTD BERM
WLL	Whiting Petroleum Corporation
WHX	Whiting USA Trust
JWB	Wiley John & Sons Inc.
WG	Willbros Group, Inc.
WMB	Williams Companies Inc
WPZ	Williams Partners L.P.
WSM	Williams-Sonoma Inc.
WSH	Willis Group Holdings Public Limited Company
WL	Wilmington Trust Corporation
WGO	Winnebago Industries, Inc.
FUR	Winthrop Realty Trust
WEC	Wisconsin Energy Corporation
WMS	WMS Industries Inc.
WWW	Wolverine World Wide Inc.
INT	World Fuel Services Corporation
WWE	World Wrestling Entertainment, Inc.
WOR	Worthington Industries, Inc.
WXS	Wright Express Corporation
WYN	Wyndham Worldwide Corporation
XEL	Xcel Energy Inc
XRM	Xerium Technologies, Inc.
XRX	Xerox Corporation
XL	XL Group plc
AUY	Yamana Gold Inc.
YUM	YUM! Brands, Inc.
ZLC	Zale Corporation
ZL	Zarlink Semiconductor, Inc.
ZEP	Zep Inc.
ZMH	Zimmer Holdings, Inc.
